200
000000000000000
0             0
0             0
0          g  0
0      333
0             0
0             0
0             0
0 s        w  0
00000022222200000