120
000000000000000
0             0
0             0
0          g  0
0        000000
0             0
0             0
0             0
0 s        w  0
000000000000000