200
000000000000000000000000
0                      0
0                      0
0                      0
0                      0
0                      0
0 s                    0
000000                 0
     0                 0
     0                 0
     0       w       g 0
     0000000000000000000