200
0000000000000000000
0                 0
0             g   0
0           0000000
0                 0
0                 0
0                 0
0               w 0
0          33333330
0                 0
033333            0
0                 0
0                 0
033333   3333333330
0                 0
0                 0
0     333333      0
0             　　  0
0            3　   0
0           3　    0
0  s       3    　 0
0000000000000000000